20 20 16 17 3 1
####################
##..###.#..........#
##.#....#....#.....#
##...#..#....#.....#
######..#....#.....#
#.......#....#.....#
#.......#....#.#####
#.#######..........#
#............#####.#
#....#..###........#
#....#....#........#
#....#....#........#
######....#........#
#....#....#........#
####.###..##########
#..................#
######..########...#
#..............#...#
#..............#...#
####################