20 20 16 17 2 1
####################
##.####......#.....#
##.#.........#.....#
##...#....####.....#
######.......#.....#
#.......#....#.....#
#.......#....#.#####
#########..........#
#.......#....#####.#
#.......####.......#
#######............#
#...........########
#..................#
######.............#
#..................#
#..................#
######..########...#
#..............#...#
#..............#...#
####################